9 0 0 0 0 9 9 0 0 0 0 0 0 0 0 0 0 0
3 1 1 1 1 6 0 0 0 9 9 9 0 0 9 9 0 0
0 0 0 0 0 6 0 0 0 0 0 0 0 0 0 0 0 0
9 0 0 0 0 6 0 9 0 1 1 1 1 1 1 6 0 9
9 0 9 9 0 6 0 0 0 7 0 0 0 0 0 6 0 9
9 9 0 9 0 6 0 9 0 7 9 0 6 8 8 8 0 9
0 0 0 9 0 6 0 0 0 7 0 0 6 0 0 0 0 0
0 0 0 0 0 6 0 0 0 7 0 0 6 0 9 9 9 9
9 9 9 9 0 1 1 1 1 7 0 0 6 0 0 0 0 0
9 9 9 9 0 0 9 9 0 9 9 9 1 1 1 1 1 4
9 9 9 9 0 9 9 9 0 0 0 0 0 0 9 9 9 9