9 9 9 9 0 0 0 0 0 0 0 0 9 9 9 0 0 9
3 1 1 1 2 9 0 2 1 1 2 0 0 0 0 0 0 9 
9 0 0 0 1 9 0 1 0 0 1 0 0 0 0 0 0 9
9 9 0 0 2 1 1 2 0 0 1 0 9 9 0 9 0 9
9 0 0 0 0 0 0 0 0 0 1 9 9 9 0 9 0 0
0 0 0 0 0 0 0 2 1 1 2 9 9 0 0 0 0 0
0 0 0 0 0 0 0 1 0 0 0 0 0 0 9 9 0 0 
9 0 0 0 0 0 0 1 0 0 2 1 1 2 9 0 0 0 
9 0 0 0 0 0 0 1 0 0 1 9 0 1 9 0 0 0
0 0 0 0 0 0 0 2 1 1 2 9 0 2 1 1 1 4
9 0 0 0 0 0 9 9 9 9 0 0 0 0 0 0 0 9 